1
1
8
0
(4 0
((0,0,0) (15,3,63) (0,0,0))
((16,0,0) (31,3,63) (0,0,0))
((32,0,0) (47,3,63) (0,0,0))
((48,0,0) (63,3,63) (0,0,0))
)
4
FabOnDisk: Cell_D_00000 0
FabOnDisk: Cell_D_00001 0
FabOnDisk: Cell_D_00002 0
FabOnDisk: Cell_D_00003 0

4,8
1.0000000000000000e+00,-4.3836495112767968e-03,5.8093677942205857e-01,0.0000000000000000e+00,0.0000000000000000e+00,9.6195057527412892e-02,1.0000000000000000e+00,2.7607981510367502e+01,
1.0000000000000000e+00,-3.1378268640062362e-03,5.8093677942205857e-01,0.0000000000000000e+00,0.0000000000000000e+00,9.6195057527412892e-02,1.0000000000000000e+00,2.7607981510367502e+01,
1.0000000000000000e+00,-3.9076719053495390e-03,5.8093677942205857e-01,0.0000000000000000e+00,0.0000000000000000e+00,9.6195057527412892e-02,1.0000000000000000e+00,2.7607981510367502e+01,
1.0000000000000000e+00,-3.7542794443327391e-03,5.8093677942205857e-01,0.0000000000000000e+00,0.0000000000000000e+00,9.6195057527412892e-02,1.0000000000000000e+00,2.7607981510367502e+01,

4,8
1.0000000000000000e+00,8.2742505203194899e-02,5.2489313999044880e+00,0.0000000000000000e+00,0.0000000000000000e+00,9.6195057527412892e-02,1.0000000000000000e+00,2.7607981510367502e+01,
1.0000000000000000e+00,4.9634487785326376e-01,5.2489313999044880e+00,0.0000000000000000e+00,0.0000000000000000e+00,9.6195057527412892e-02,1.0000000000000000e+00,2.7607981510367502e+01,
1.0000000000000000e+00,4.5058478047004236e-01,5.2489313999044880e+00,0.0000000000000000e+00,0.0000000000000000e+00,9.6195057527412892e-02,1.0000000000000000e+00,2.7607981510367502e+01,
1.0000000000000000e+00,2.3723914749965627e-04,5.2489313999044880e+00,0.0000000000000000e+00,0.0000000000000000e+00,9.6195057527412892e-02,1.0000000000000000e+00,2.7607981510367502e+01,

