1
1
5
0
(4 0
((0,0,0) (7,7,15) (0,0,0))
((8,0,0) (15,7,15) (0,0,0))
((0,8,0) (7,15,15) (0,0,0))
((8,8,0) (15,15,15) (0,0,0))
)
4
FabOnDisk: Cell_D_00000 0
FabOnDisk: Cell_D_00001 0
FabOnDisk: Cell_D_00002 0
FabOnDisk: Cell_D_00003 0

4,5
1.0000000000000000e+00,1.0000000000000000e+02,0.0000000000000000e+00,0.0000000000000000e+00,-1.2960651375320086e+01,
1.0000000000000000e+00,1.0000000000000000e+02,0.0000000000000000e+00,0.0000000000000000e+00,-1.2022853676102937e+01,
1.0000000000000000e+00,1.0000000000000000e+02,0.0000000000000000e+00,0.0000000000000000e+00,-1.2960651375320086e+01,
1.0000000000000000e+00,1.0000000000000000e+02,0.0000000000000000e+00,0.0000000000000000e+00,-1.2022853676102937e+01,

4,5
1.0000000000000000e+00,1.0000000000000000e+02,0.0000000000000000e+00,0.0000000000000000e+00,1.3293397894411363e+01,
1.0000000000000000e+00,1.0000000000000000e+02,0.0000000000000000e+00,0.0000000000000000e+00,1.1963169826222012e+01,
1.0000000000000000e+00,1.0000000000000000e+02,0.0000000000000000e+00,0.0000000000000000e+00,1.3293397894411363e+01,
1.0000000000000000e+00,1.0000000000000000e+02,0.0000000000000000e+00,0.0000000000000000e+00,1.1963169826222012e+01,

