1
1
5
0
(4 0
((0,0,0) (7,7,15) (0,0,0))
((8,0,0) (15,7,15) (0,0,0))
((0,8,0) (7,15,15) (0,0,0))
((8,8,0) (15,15,15) (0,0,0))
)
4
FabOnDisk: Cell_D_00000 0
FabOnDisk: Cell_D_00001 0
FabOnDisk: Cell_D_00002 0
FabOnDisk: Cell_D_00003 0

4,5
1.0000000000000000e+00,1.0000000000000000e+02,0.0000000000000000e+00,0.0000000000000000e+00,-1.3390997318820691e+01,
1.0000000000000000e+00,1.0000000000000000e+02,0.0000000000000000e+00,0.0000000000000000e+00,-5.5709559676740872e-01,
1.0000000000000000e+00,1.0000000000000000e+02,0.0000000000000000e+00,0.0000000000000000e+00,-1.3390997318820691e+01,
1.0000000000000000e+00,1.0000000000000000e+02,0.0000000000000000e+00,0.0000000000000000e+00,-5.5709559676740872e-01,

4,5
1.0000000000000000e+00,1.0000000000000000e+02,0.0000000000000000e+00,0.0000000000000000e+00,1.4521191579236408e+01,
1.0000000000000000e+00,1.0000000000000000e+02,0.0000000000000000e+00,0.0000000000000000e+00,5.6840922458238285e-01,
1.0000000000000000e+00,1.0000000000000000e+02,0.0000000000000000e+00,0.0000000000000000e+00,1.4521191579236408e+01,
1.0000000000000000e+00,1.0000000000000000e+02,0.0000000000000000e+00,0.0000000000000000e+00,5.6840922458238285e-01,

